0000000000000000000000000000000000000000000000000000000000000000000000000000000000000000000000000000
0000000000000000000000000000000000000000000000000000000000000000000000000000000000000000000000000000
0000000000000000000000000000000000000000000000000000000000000000000000000000000000000000000000000000
0000000000000000000000000000000000000000000000000000000000000000000000000000000000000000000000000000
0000000000000000000000000000000000000000000000000000000000000000000000000000000000000000000000000000
0000000000000000000000000000000000000000000000000000000000000000000000000000000000000000000000000000
0000000000000000000000000000000000000000000000000000000000000000000000000000000000000000000000000000
0000000000000000000000000000000000000000000000000000000000000000000000000000000000000000000000000000
0000000000000000000000000000000000000000000000000000000000000000000000000000000000000000000000000000
0000000000000000000000000000000000000000000000000000000000000000000000000000000000000000000000000000
0000000000000000000000000000000000000000000000000000000000000000000000000000000000000000000000000000
0000000000000000000000000000000000000000000000000000000000000000000000000000000000000000000000000000
0000000000000000000000000000000000000000000000000000000000000000000000000000000000000000000000000000
0000000000000000000000000000000000000000000000000000000000000000000000000000000000000000000000000000
0000000000000000000000000000000000000000000000000000000001111111111100000000000000000000000000000000
0000000000000000000000000000000000000000000000000000000001111111111100000000000000000000000000000000
0000000000000000000000000000000000000000000000000000000001111111111100000000000000000000000000000000
0000000000000000000000000000000000000000000000000000000001111111111100000000000000000000000000000000
0000000000000000000000000000000000000000000000000000000001111111111100000000000000000000000000000000
0000000000000000000000000000000000000000000000000000000001111111111100000000000000000000000000000000
0000000000000000000000000000000000000000000000000000000001111111111100000000000000000000000000000000
0000000000000000000000000000000000000000000000000000000001111111111100000000000000000000000000000000
0000000000000000000000000000000000000000000000000000000001111111111100000000000000000000000000000000
0000000000000000000000000000000000000000000000000000000001111111111100000000000000000000000000000000
0000000000000000000000000000000000000000000000000000000001111111111100000000000000000000000000000000
0000000000000000000000000000000000000000000000000000000001111111111100000000000000000000000000000000
0000000000000000000000000000000000000000000000000000000001111111111100000000000000000000000000000000
0000000000000000000000000000000000000000000000000000000000000000000000000000000000000000000000000000
0000000000000000000000000000000000000000000000000000000000000000000000000000000000000000000000000000
0000000000000000000000000000000000000000000000000000000000000000000000000000000000000000000000000000
0000000000000000000000000000000000000000000000000000000000111111111000000000000011111111100000000000
0000000000000000000000000000000000000000000000000000000000111111111000111111100011111111100000000000
0000000000000000000000000000000000011111110000111111111000111111111000111111100011111111100000000000
0000000000000000000000000000000000011111110000111111111000111111111000111111100011111111100000000000
0000000000000000000000000000000000011111110000111111111000111111111000111111100011111111100000000000
0000000000000000000000000000000000011111110000111111111000111111111000111111100011111111100000000000
0000000000000000000000000000000000011111110000111111111000111111111000111111100011111111100000000000
0000000000000000000000000000000000011111110000111111111000111111111000111111100011111111100000000000
0000000000000000000000000000000000011111110000111111111000111111111000111111100011111111100000000000
0000000000000000000000000000000000011111110000111111111000111111111000111111100011111111100000000000
0000000000000000000000000000000000011111110000111111111000111111111000000000000011111111100000000000
0000000000000000000000000000000000000000000000111111111000000000000000000000000000000000000000000000
0000000000000000000000000000000000000000000000111111111000000000000000000000000000000000000000000000
0000000000000000000000000000000000000000000000000000000000000000000000000000000000000000000000000000
0000000000000000000000000000000001111111111100000000000001111111111100011111111111000000000000000000
0000000000000000000001111111110001111111111100000000000001111111111100011111111111000000000000000000
0000000000000000000001111111110001111111111100011111110001111111111100011111111111000000000000000000
0000000000000000000001111111110001111111111100011111110001111111111100011111111111000000000000000000
0000000000000000000001111111110001111111111100011111110001111111111100011111111111000000000000000000
0000000000000000000001111111110001111111111100011111110001111111111100011111111111000000000000000000
0000000000000000000001111111110001111111111100011111110001111111111100011111111111000000000000000000
0000000000000000000001111111110001111111111100011111110001111111111100011111111111000000000000000000
0000000000000000000001111111110001111111111100011111110001111111111100011111111111000000000000000000
0000000000000000000001111111110001111111111100011111110001111111111100011111111111000000000000000000
0000000000000000000001111111110001111111111100011111110001111111111100011111111111000000000000000000
0000000000000000000001111111110001111111111100000000000001111111111100011111111111000000000000000000
0000000000000000000000000000000001111111111100000000000001111111111100011111111111000000000000000000
0000000000000000000000000000000000000000000000000000000000000000000000000000000000000000000000000000
0000000000000000000000000000000000000000000000011111110000000000000000000000000000000000000000000000
0000000000000000000000000000000000000000000000011111110000000000000000000000000000000000000000000000
0000000000000000000000000000000001111111111100011111110000111111111000000000000000000000000000000000
0000000000000000000000000000000001111111111100011111110000111111111000111111100000000000000000000000
0000000000000000000000000000000001111111111100011111110000111111111000111111100000000000000000000000
0000000000000000000000000000000001111111111100011111110000111111111000111111100000000000000000000000
0000000000000000000000000000000001111111111100011111110000111111111000111111100000000000000000000000
0000000000000000000000000000000001111111111100011111110000111111111000111111100000000000000000000000
0000000000000000000000000000000001111111111100011111110000111111111000111111100000000000000000000000
0000000000000000000000000000000001111111111100000000000000111111111000111111100000000000000000000000
0000000000000000000000000000000001111111111100000000000000111111111000111111100000000000000000000000
0000000000000000000000000000000001111111111100000000000000111111111000111111100000000000000000000000
0000000000000000000000000000000001111111111100000000000000111111111000000000000000000000000000000000
0000000000000000000000000000000001111111111100000000000000000000000000000000000000000000000000000000
0000000000000000000000000000000001111111111100000000000000000000000000000000000000000000000000000000
0000000000000000000000000000000000000000000000000000000000000000000000000000000000000000000000000000
0000000000000000000000000000000000000000000000000000000000000000000000000000000000000000000000000000
0000000000000000000000000000000000000000000000000000000000000000000000000000000000000000000000000000
0000000000000000000000000000000000000000000000000000000000000000000000000000000000000000000000000000
0000000000000000000000000000000000000000000000000000000000000000000000000000000000000000000000000000
0000000000000000000000000000000000000000000000000000000000000000000000000000000000000000000000000000
0000000000000000000000000000000000000000000000000000000000000000000000000000000000000000000000000000
0000000000000000000000000000000000000000000000000000000000000000000000000000000000000000000000000000
0000000000000000000000000000000000000000000000000000000000000000000000000000000000000000000000000000
0000000000000000000000000000000000000000000000000000000000000000000000000000000000000000000000000000
0000000000000000000000000000000000000000000000000000000000000000000000000000000000000000000000000000
0000000000000000000000000000000000000000000000000000000000000000000000000000000000000000000000000000
0000000000000000000000000000000000000000000000000000000000000000000000000000000000000000000000000000
0000000000000000000000000000000000000000000000000000000000000000000000000000000000000000000000000000
0000000000000000000000000000000000000000000000000000000000000000000000000000000000000000000000000000
0000000000000000000000000000000000000000000000000000000000000000000000000000000000000000000000000000
0000000000000000000000000000000000000000000000000000000000000000000000000000000000000000000000000000
0000000000000000000000000000000000000000000000000000000000000000000000000000000000000000000000000000
0000000000000000000000000000000000000000000000000000000000000000000000000000000000000000000000000000
0000000000000000000000000000000000000000000000000000000000000000000000000000000000000000000000000000
0000000000000000000000000000000000000000000000000000000000000000000000000000000000000000000000000000
0000000000000000000000000000000000000000000000000000000000000000000000000000000000000000000000000000
0000000000000000000000000000000000000000000000000000000000000000000000000000000000000000000000000000
0000000000000000000000000000000000000000000000000000000000000000000000000000000000000000000000000000
0000000000000000000000000000000000000000000000000000000000000000000000000000000000000000000000000000
0000000000000000000000000000000000000000000000000000000000000000000000000000000000000000000000000000
0000000000000000000000000000000000000000000000000000000000000000000000000000000000000000000000000000
